
* * * * * * * * E * 
*                 * 
*   * # # * * * * * 
*     # *       # * 
* *   * *   * * * * 
* *         # $   * 
* *   * * * * *   * 
* *               * 
* *   * * * * * # * 
* * ^ * * * * * * * 
